"filename", "language", "C++", "Makefile", "Markdown", "comment", "blank", "total"
"d:\school\challenges-cpp-final-app-DylanMissu\Makefile", "Makefile", 0, 26, 0, 14, 12, 52
"d:\school\challenges-cpp-final-app-DylanMissu\README.md", "Markdown", 0, 0, 15, 0, 8, 23
"d:\school\challenges-cpp-final-app-DylanMissu\src\lib\Console.cpp", "C++", 26, 0, 0, 0, 3, 29
"d:\school\challenges-cpp-final-app-DylanMissu\src\lib\Console.h", "C++", 12, 0, 0, 0, 3, 15
"d:\school\challenges-cpp-final-app-DylanMissu\src\lib\Graphics.cpp", "C++", 57, 0, 0, 0, 8, 65
"d:\school\challenges-cpp-final-app-DylanMissu\src\lib\Graphics.h", "C++", 19, 0, 0, 0, 5, 24
"d:\school\challenges-cpp-final-app-DylanMissu\src\lib\TetrisBlock.cpp", "C++", 117, 0, 0, 1, 17, 135
"d:\school\challenges-cpp-final-app-DylanMissu\src\lib\TetrisBlock.h", "C++", 27, 0, 0, 1, 6, 34
"d:\school\challenges-cpp-final-app-DylanMissu\src\lib\Timer.cpp", "C++", 41, 0, 0, 1, 7, 49
"d:\school\challenges-cpp-final-app-DylanMissu\src\lib\Timer.h", "C++", 16, 0, 0, 0, 3, 19
"d:\school\challenges-cpp-final-app-DylanMissu\src\lib\UserInput.cpp", "C++", 40, 0, 0, 1, 7, 48
"d:\school\challenges-cpp-final-app-DylanMissu\src\lib\UserInput.h", "C++", 14, 0, 0, 0, 2, 16
"d:\school\challenges-cpp-final-app-DylanMissu\src\lib\resources\Shapes.h", "C++", 47, 0, 0, 0, 2, 49
"d:\school\challenges-cpp-final-app-DylanMissu\src\main.cpp", "C++", 40, 0, 0, 0, 9, 49
"Total", "-", 456, 26, 15, 18, 92, 607